BRRBRRRRRB
BEBREBBBRR
RERBEREBBB
ERBBRBEBRB
BBRREBRBRR
RBEEBRBBRB
RBREEEBRBR
